AAwAAAAAAAAAAA
AwAAAAAAAAAAAA
wAAAAwwwwwwwAA
AAAAAwAAAAAwAA
AAAAAAAAAAAwAA
AAAAAwAAAAAwAA
AAAAAwAAAAAwAA
AAAAAwAAAAAwAA
AAAAAwAAAAAAAA
AAAAAwAAAAAwAA
AAAAAwAAAAAwAA
AAwwwwwwwwwwAA
AAAAAAAAAAAAAA
AAAAAAAAAAAAAAE
01234567890123
